000000000000000000000000000000000WWWWWWW0000000000000000000000000000000000000000
0                                                                              0
0                                                                              0
0                                                                              0
0                                                                              0
0                                                                              0
0                                                                              0
0BB                                                                            0
0                                                                              0
0               WWW    WW                                                      0
0          E   WWWWWWWWWWWWWW  E              WWWWW           L                0
WWWWWWWWWWWWWWWWWWWWWWWWWWWWWWWWWWWWWWWWWWWWWWWWWWWWWWWWWWWWWWWWWWWWWWWWWWWWWWWW