00000000000000000000000000000000000000000000000000000000000000000000000000000000000000000000
0                                                                                          0
0                                                                                          0
0                                                                                          0
0                                                                                          0
0                                                                                          0
0                                                                                  L       0
0                                              S              S                   SSS      0
0                                         SS                              S   S            0
0                             SSS    S              SSSSSSSS     S    S                    0
0     P               SSS                                                                  0
0                                                                                          0
0                      E   E    E    E   E  E   E    E     E      E     E     EE           0
SSSSSSSSSSSSSSSSSSSSSSSSSSSSSSSSSSSSSSSSSSSSSSSSSSSSSSSSSSSSSSSSSSSSSSSSSSSSSSSSSSSSSSSSSSSS