00000000000000000000000000000000000000000000000000000000000000000000000000000000000000000000
0                                                                                          0
0                                                                                          0
0                                                                                          0
0                                                                                          0
0                                                                                          0
0                                                                                          0
0                                              S                                           0
0                                         SS      S       L                                0
0                             SSS    S              SSSS SSS                               0
0     P               SSS                                                                  0
0               S                                                                          0
0                 E  E E  E E  E    E    E   E  E   E    E     E      E     E     EE       0
SSSSSSSSSSSSSSSSSSSSSSSSSSSSSSSSSSSSSSSSSSSSSSSSSSSSSSSSSSSSSSSSSSSSSSSSSSSSSSSSSSSSSSSSSSSS